30	30
000000000000000010000000000000
000000000000000010000000000000
000111000000000010000000000000
001001000000100000000000000000
010010100001110000000000000000
010001100011001000100000000000
001111100011111000100000000000
000111000011100000100000000000
000000011111000000000000000000
000000011000000000000000000000
000000001000001000000000000000
000110000000010100111001110000
001010000000000000001111001000
000000000000010000001100001000
000000000000001000100011100000
011100000000000010000001000000
000000000000000000000000000000
000000010010001001000000000000
000011000011001000000000000000
000000111011000100100000000000
000000000001000001000000000000
000000000010000011000000000000
000000000000000111000000000000
000000000000001011000000000000
000000000000000000000000110000
000000000000110000000011001000
000000000000100000000000011000
000000000000100000000100000000
000000000000000000000011000000
000000000000000000000000000000
